NO ./img/bluestone.xpm
SO ./img/mossy.xpm
WE ./img/redbrick.xpm
EA ./img/colorstone.xpm
F 220,100,0
C 255,1,0

111111111111111111111111111111111111111111111111111111111111111111111111111111
100000000000000000000000000000000000000000000000000000000000000000000000000001
100000000000000000000000000000000000000000000000000000000000000000000000000001
100000000000000000000000000000000000000000000000000000000000000000000000000001
100000000000000000000000000000000000000000000000000000000000000000000000000001
100000000000000000000000000000000000000000000000000000000000000000000000000001
100000000000110000000000000000000000000000000000000000000000000000000000000001
100000000000110000000000000000000000000000000000000000000000000000000000000001
100000000000000000000000000011000000000000000000000000000000000000000000000001
10000000000000000000000000001100000S000000000000000000000000000000000000000001
100000000000000000000000000001000000000000000000000000000000000000000000000001
100000000000000000000000000001000000000000000000000000000000000000000000000001
100000000000000000000000000011000000000000000000000000000000000000000000000001
100000000000000000000000000000000000000000000000000000000000000000000000000001
100000000000000000000000000000000000000000000000000000000000000000000000000001
100000000000000000000011111111111111110000000000000000111000110000000000000001
100000000000000000000011111111111111111100000000000000000110000100000000000011
100000000000000000000011111111111111110000000000000000001000100000000000000001
100000000000000000000000000000000000000000000000000000000000000000000000000001
100000000000000000000000000000000000000000000000000000000000000000000000000001
100000000000000000000000000000000000000000000000000000000000000000000000000001
100000000000000000000000000000000000000000000000000000000000000000000000000001
100000000000000000000000000000000000000000000000000000000000000000000000000001
100000000000000000000000000000000000000000000000000000000000000000000000000001
100000000000000000000000000000000000000000000000000000000000000000000000000001
100000000000000000000000000000000000000000000000000000000000000000000000000001
100000000000000000000000000000000000000000000000000000000000000000000000000001
100000000000000000000000000000000000000000000000000000000000000000000000000001
100000000000000000000000000000000000000000000000000000000000000000000000000001
100000000000000000000000000000000000000000000000000000000000000000000000000001
100000000000000000000000000000000000000000000000000000000000000000000000000001
100000000000000000000000000000000000000000000000000000000000000000000000000001
111111111111111111111111111111111111111111111111111111111111111111111111111111